111111111111111111
10010000C10000C001
100C01111100111101
100111000000000001
10001001100C000111
1P00001C00111CCCE1
111111111111111111
