11111111111111111111111111
10001000000010000000000001
10111000000010000000000001
100000000000100E0000000001
10000000000000000000000001
11100000000010000000000001
1P000000000010000000000001
11111111111111111111111111