111111111111111111111111111111111111111111111111111111111111111111111111111111
100C0000000010000000000001100C0000000010000000000001100C0000000010000000000001
100000000000100E00000000011000000000000000000000000110000000000000000000000001
100000P00000100000000000011000000000000000000000000110000000000000000000000001
100000000000000000000000000000000000001000000000000000000000000010000000000001
100000000000100000000000011000000000001000000000000110000000000010000000000001
100000000000100000000000011000000000001000000000000110000000000010000000000001
111111111111111111111111111111111111111111111111111111111111111111111111111111