111111111111111111111111111111111
1E0000000000000C00000C000000C0001
1010010100100000101001000000C0001
1010010010101010001001000000C0001
100000000C00C000000000000000C0001
100000000000000C00000C000000C0001
1010010100100000101001000000C0001
1010010010101010001001000000C0001
110000000C00C000000000000000C0001
110000000000000C00000C000000C0001
1010010100100000101001000000C0001
1010010010101010001001000000C0001
100000000C00C000000000000000C0001
100000000000000C00000C000000C0001
1010010100100000101001000000C0001
1010010010101010001001000000C0001
100000000C00C000000000000000C0001
100000000000000C00000C000000C0001
1010010100100000101001000000C0001
1010010010101010001001000000C0001
1P0000000C00C000000000000000C0001
111111111111111111111111111111111